####################
#       #          #
#     #         # ##
##              ####
#      #     # #  ##
# ##  # # #    #  ##
#     #    ##      #
#E             #   #
# #  #####      #  #
## # ##       #   ##
#             # ## #
###  #      #      #
# #  ##      #     #
#      #      # #  #
#  #   # #         #
#     #    #       #
#     #  ##        #
#           #  # #S#
#    ##            #
####################
