##############
#   #   #    #
#          # #
# #          #
#            #
##   #      ##
#            #
#  #         #
# #        # #
# #   #     ##
#  ##        #
#E#       #  #
### ##  #    #
#            #
#        #   #
# #    #    S#
# #  #       #
#           ##
##############
