###############
### #         #
#  #   #    # #
##     #      #
###      # #  #
#E#   # #   # #
#  #         S#
## #          #
#      #      #
# #    ##    ##
# #    ##   # #
#         # # #
# ## #     # ##
#       #   # #
###############
