##########
#       S#
##       #
#    # ###
#     #  #
#      # #
#        #
#      ###
## # #   #
#        #
# ##     #
#        #
#        #
##       #
#        #
#  ####  #
#E   #   #
##########
