###############
#             #
# #     #  # ##
#   #   #     #
#     ## #    #
#    #        #
##       # ## #
#    #        #
###   #    # S#
##  #       ###
#   #         #
##       #    #
#E ## #       #
#   ##   # #  #
###############
