###############
#          ## #
#   # #  # ## #
#    #       ##
##   #  ##   S#
#   #    #### #
# # ## #    # #
#   #  #      #
##      #     #
#     #  ##   #
#   ##        #
#             #
#E  # # ####  #
#  #  #   #   #
###############
