###############
#  #   ##     #
# ##      #   #
#E #      #   #
#      #   ## #
# #      # # ##
#         #   #
##  #         #
###   #     # #
#     #  #    #
# #   ###     #
#            S#
#  #       #  #
#     #       #
###############
